1 1 1 1 1 1 1 1 1 1 1 1 1 1 1 1 1 1 1 1 1 1 1 1 1 1 1 1 1 1 1
1 4 0 0 0 0 0 2 2 0 2 0 0 5 0 2 0 6 0 2 0 0 2 0 2 0 2 0 0 0 1
1 0 1 0 1 0 1 2 1 0 1 0 1 2 1 2 1 0 1 0 1 0 1 2 1 2 1 2 1 0 1
1 0 0 2 2 0 0 0 0 0 2 2 2 0 0 2 0 0 5 0 0 0 2 0 6 0 2 0 2 0 1
1 0 1 0 1 8 1 0 1 0 1 2 1 0 1 0 1 2 1 2 1 0 1 0 1 0 1 0 1 2 1
1 9 0 0 0 0 0 0 0 0 0 2 0 2 2 0 0 2 0 0 2 0 0 0 5 0 0 0 0 0 1
1 0 1 0 1 0 1 0 1 0 1 0 1 0 1 0 1 0 1 2 1 0 1 2 1 0 1 0 1 0 1
1 2 0 0 2 7 0 0 0 0 0 2 0 0 2 0 0 0 0 0 0 2 0 0 0 0 0 0 0 0 1 
1 0 1 0 1 0 1 0 1 2 1 0 1 0 1 0 1 2 1 2 1 0 1 0 1 0 1 0 1 0 1
1 2 0 0 0 0 2 2 0 0 2 0 0 0 0 0 0 0 2 0 0 0 0 0 0 0 0 0 0 0 1
1 0 1 2 1 8 1 0 1 0 1 0 1 0 1 0 1 2 1 0 1 0 1 0 1 0 1 0 1 0 1
1 0 0 0 0 0 0 0 0 0 0 0 2 0 0 0 2 0 0 2 0 0 0 0 0 0 0 0 0 0 1
1 1 1 1 1 1 1 1 1 1 1 1 1 1 1 1 1 1 1 1 1 1 1 1 1 1 1 1 1 1 1

# 1
* 2
x 3
1 balloon 5
2 oneal 6
f flame item

# # # # # # # # # # # # # # # # # # # # # # # # # # # # # # #
# p           * *   *     1   *   2   *     *   *   *       #
#   #   #   # * #   #   # * # * #   #   #   # * # * # * #   #
#     x *           * * *     *     1       *   2   *   *   #
#   #   #   #   #   # * #   #   # * # * #   #   #   #   # * #
# f                   x   * *     *     *       1           #
#   #   #   #   #   #   #   #   #   # * #   # * #   #   #   #
# *     *             *     *             *                 #
#   #   #   #   # * #   #   #   # * # * #   #   #   #   #   #
# *         * *     *               *                       #
#   # * #   #   #   #   #   #   # * #   #   #   #   #   #   #
#                       *       *     *                     #
# # # # # # # # # # # # # # # # # # # # # # # # # # # # # # #
