1 1 1 1 1 1 1 1 1 1 1 1 1 1 1 1 1 1 1 1 1 1 1 1 1 1 1 1 1 1 1
1 4 0 0 0 0 10 2 2 0 2 0 0 5 0 2 0 6 0 2 0 0 2 0 2 0 2 0 0 0 1
1 0 1 0 1 0 1 0 1 0 1 0 1 2 1 2 1 0 1 0 1 0 1 2 1 2 1 2 1 0 1
1 0 0 3 2 0 0 0 0 0 2 2 2 0 0 2 0 0 0 0 0 0 2 0 0 0 2 0 2 0 1
1 9 1 0 1 0 1 0 1 0 1 2 1 0 1 0 1 2 1 2 1 0 1 0 1 0 1 0 1 2 1
1 2 0 0 0 0 0 0 0 0 0 3 0 2 2 0 0 2 0 0 2 0 0 0 6 0 0 0 0 0 1
1 0 1 0 1 0 1 0 1 0 1 0 1 0 1 0 1 0 1 2 1 0 1 2 1 0 1 0 1 0 1
1 2 0 0 2 0 0 0 0 0 0 2 0 0 2 0 0 0 0 0 0 2 0 0 0 0 8 0 0 0 1
1 0 1 0 1 0 1 0 1 0 1 0 1 0 1 0 1 2 1 2 1 0 1 0 1 0 1 0 1 0 1
1 2 0 0 0 0 2 2 0 0 2 0 0 0 0 0 0 0 2 0 0 0 8 0 0 0 0 0 0 0 1
1 2 1 2 1 0 1 0 1 0 1 0 1 0 1 0 1 2 1 0 1 0 1 0 1 0 1 0 1 0 1
1 0 0 7 0 0 0 0 0 0 0 0 2 0 0 0 2 0 0 2 0 0 0 0 0 0 0 0 0 0 1
1 1 1 1 1 1 1 1 1 1 1 1 1 1 1 1 1 1 1 1 1 1 1 1 1 1 1 1 1 1 1

1 Wall; 2 Brick; 3 Portal; 4 Bomber
5 balloon; 6 oneal; 7 doll; 8 doria
9 speeditem; 10 bombitem; 11 flame;


# # # # # # # # # # # # # # # # # # # # # # # # # # # # # # #
# p           * *   *     1   *   2   *     *   *   *       #
#   #   #   # * #   #   # * # * #   #   #   # * # * # * #   #
#     x *           * * *     *     1       *   2   *   *   #
#   #   #   #   #   # * #   #   # * # * #   #   #   #   # * #
# f                   x   * *     *     *       1           #
#   #   #   #   #   #   #   #   #   # * #   # * #   #   #   #
# *     *             *     *             *                 #
#   #   #   #   # * #   #   #   # * # * #   #   #   #   #   #
# *         * *     *               *                       #
#   # * #   #   #   #   #   #   # * #   #   #   #   #   #   #
#                       *       *     *                     #
# # # # # # # # # # # # # # # # # # # # # # # # # # # # # # #
